//MAP CONVERTED BY dmm2tgm.py THIS HEADER COMMENT PREVENTS RECONVERSION, DO NOT REMOVE
"a" = (
/turf/closed/wall/mineral/titanium,
/area/shuttle/supply)
"b" = (
/obj/effect/turf_decal/stripes/line{
	dir = 9
	},
/obj/effect/decal/cleanable/dirt,
/turf/open/floor/mineral/titanium/yellow,
/area/shuttle/supply)
"c" = (
/obj/effect/turf_decal/stripes/line{
	dir = 1
	},
/turf/open/floor/mineral/titanium/yellow,
/area/shuttle/supply)
"d" = (
/obj/effect/turf_decal/stripes/line{
	dir = 1
	},
/obj/effect/decal/cleanable/dirt,
/turf/open/floor/mineral/titanium/yellow,
/area/shuttle/supply)
"e" = (
/obj/effect/turf_decal/stripes/line{
	dir = 8
	},
/turf/open/floor/mineral/titanium/yellow,
/area/shuttle/supply)
"f" = (
/obj/effect/turf_decal/bot,
/obj/effect/decal/cleanable/dirt,
/turf/open/floor/mineral/titanium,
/area/shuttle/supply)
"g" = (
/obj/effect/turf_decal/stripes/line{
	dir = 4
	},
/turf/open/floor/mineral/titanium/yellow,
/area/shuttle/supply)
"h" = (
/obj/effect/turf_decal/stripes/line{
	dir = 5
	},
/obj/effect/decal/cleanable/dirt,
/turf/open/floor/mineral/titanium/yellow,
/area/shuttle/supply)
"i" = (
/obj/effect/turf_decal/stripes/line,
/turf/open/floor/mineral/titanium/yellow,
/area/shuttle/supply)
"j" = (
/obj/effect/turf_decal/stripes/line{
	dir = 6
	},
/turf/open/floor/mineral/titanium/yellow,
/area/shuttle/supply)
"k" = (
/obj/machinery/conveyor{
	dir = 4;
	id = "QMLoad"
	},
/obj/machinery/door/poddoor{
	id = "QMLoadDoor";
	name = "Cargo Loading Door"
	},
/obj/effect/turf_decal/stripes/line{
	dir = 8
	},
/obj/effect/turf_decal/stripes/line{
	dir = 4
	},
/turf/open/floor/plating,
/area/shuttle/supply)
"l" = (
/obj/effect/turf_decal/bot,
/turf/open/floor/mineral/titanium,
/area/shuttle/supply)
"m" = (
/obj/structure/shuttle/engine/heater,
/obj/structure/window/reinforced{
	dir = 1;
	pixel_y = 1
	},
/turf/open/floor/plating/airless,
/area/shuttle/supply)
"n" = (
/obj/effect/turf_decal/stripes/line{
	dir = 1
	},
/obj/machinery/light/small{
	dir = 1
	},
/turf/open/floor/mineral/titanium/yellow,
/area/shuttle/supply)
"o" = (
/obj/structure/shuttle/engine/propulsion/burst/left,
/turf/open/floor/plating/airless,
/area/shuttle/supply)
"p" = (
/obj/structure/shuttle/engine/propulsion/burst,
/turf/open/floor/plating/airless,
/area/shuttle/supply)
"q" = (
/obj/structure/shuttle/engine/propulsion/burst/right,
/turf/open/floor/plating/airless,
/area/shuttle/supply)
"r" = (
/obj/effect/turf_decal/stripes/line{
	dir = 8
	},
/obj/effect/decal/cleanable/dirt,
/turf/open/floor/mineral/titanium/yellow,
/area/shuttle/supply)
"s" = (
/obj/machinery/door/airlock/shuttle{
	name = "Supply Freighter Airlock";
	req_access_txt = "31"
	},
/obj/effect/decal/cleanable/dirt,
/obj/effect/turf_decal/stripes/line{
	dir = 4
	},
/obj/effect/turf_decal/stripes/line{
	dir = 8
	},
/turf/open/floor/mineral/titanium/yellow,
/area/shuttle/supply)
"t" = (
/obj/effect/turf_decal/stripes/line{
	dir = 8
	},
/obj/machinery/light{
	dir = 8
	},
/obj/machinery/button/door{
	id = "QMUnloadDoor";
	layer = 4;
	name = "Cargo Unloading Doors";
	pixel_x = -24;
	pixel_y = -6
	},
/obj/machinery/button/door{
	id = "QMLoadDoor";
	layer = 4;
	name = "Cargo Loading Doors";
	pixel_x = -24;
	pixel_y = 6
	},
/turf/open/floor/mineral/titanium/yellow,
/area/shuttle/supply)
"u" = (
/obj/effect/turf_decal/stripes/line{
	dir = 4
	},
/obj/machinery/light{
	dir = 4
	},
/turf/open/floor/mineral/titanium/yellow,
/area/shuttle/supply)
"v" = (
/obj/machinery/conveyor{
	dir = 8;
	id = "QMUnload"
	},
/obj/machinery/door/poddoor{
	id = "QMUnloadDoor";
	name = "Cargo Unloading Door"
	},
/obj/effect/turf_decal/stripes/line{
	dir = 4
	},
/obj/effect/turf_decal/stripes/line{
	dir = 8
	},
/turf/open/floor/plating,
/area/shuttle/supply)
"w" = (
/obj/structure/sign/nanotrasen,
/turf/closed/wall/mineral/titanium,
/area/shuttle/supply)
"x" = (
/obj/structure/sign/departments/cargo,
/turf/closed/wall/mineral/titanium,
/area/shuttle/supply)
"y" = (
/obj/structure/sign/warning/nosmoking/circle,
/turf/closed/wall/mineral/titanium,
/area/shuttle/supply)
"z" = (
/obj/structure/sign/warning/fire,
/turf/closed/wall/mineral/titanium,
/area/shuttle/supply)
"A" = (
/obj/machinery/door/airlock/shuttle{
	name = "Supply Freighter Airlock";
	req_access_txt = "31"
	},
/obj/effect/decal/cleanable/dirt,
/obj/docking_port/mobile/supply{
	dir = 4;
	dwidth = 4;
	width = 12
	},
/obj/effect/turf_decal/stripes/line{
	dir = 8
	},
/obj/effect/turf_decal/stripes/line{
	dir = 4
	},
/turf/open/floor/mineral/titanium/yellow,
/area/shuttle/supply)
"B" = (
/turf/template_noop,
/area/template_noop)
"C" = (
/obj/effect/turf_decal/stripes/line{
	dir = 4
	},
/obj/effect/decal/cleanable/dirt,
/turf/open/floor/mineral/titanium/yellow,
/area/shuttle/supply)
"D" = (
/obj/effect/turf_decal/bot,
/obj/effect/decal/cleanable/glass,
/turf/open/floor/mineral/titanium,
/area/shuttle/supply)
"E" = (
/obj/effect/turf_decal/delivery,
/obj/effect/decal/cleanable/dirt,
/turf/open/floor/mineral/titanium,
/area/shuttle/supply)
"F" = (
/obj/effect/turf_decal/stripes/line{
	dir = 10
	},
/obj/effect/decal/cleanable/dirt,
/turf/open/floor/mineral/titanium/yellow,
/area/shuttle/supply)
"G" = (
/obj/effect/turf_decal/stripes/line,
/obj/effect/decal/cleanable/dirt,
/turf/open/floor/mineral/titanium/yellow,
/area/shuttle/supply)
"H" = (
/obj/effect/turf_decal/bot,
/obj/effect/decal/cleanable/oil{
	icon_state = "floor5"
	},
/turf/open/floor/mineral/titanium,
/area/shuttle/supply)

(1,1,1) = {"
a
a
a
k
A
a
s
v
a
a
a
B
"}
(2,1,1) = {"
a
b
r
e
r
t
e
e
F
y
a
o
"}
(3,1,1) = {"
a
d
f
l
f
l
H
l
i
E
m
p
"}
(4,1,1) = {"
a
n
l
f
l
l
f
f
G
E
m
p
"}
(5,1,1) = {"
a
c
f
l
l
D
l
l
G
E
m
p
"}
(6,1,1) = {"
a
h
C
C
g
u
C
g
j
z
a
q
"}
(7,1,1) = {"
a
a
a
w
a
a
a
x
a
a
a
B
"}
