//MAP CONVERTED BY dmm2tgm.py THIS HEADER COMMENT PREVENTS RECONVERSION, DO NOT REMOVE
"a" = (
/obj/structure/sign/nanotrasen,
/turf/closed/wall/mineral/titanium,
/area/shuttle/mining)
"b" = (
/turf/closed/wall/mineral/titanium,
/area/shuttle/mining)
"c" = (
/obj/effect/spawner/structure/window/shuttle,
/turf/open/floor/plating,
/area/shuttle/mining)
"d" = (
/obj/structure/table/reinforced,
/obj/machinery/light/small{
	brightness = 3;
	dir = 8
	},
/obj/item/storage/toolbox/emergency,
/turf/open/floor/mineral/titanium,
/area/shuttle/mining)
"e" = (
/obj/machinery/computer/shuttle/mining,
/turf/open/floor/mineral/titanium,
/area/shuttle/mining)
"f" = (
/obj/structure/table/reinforced,
/obj/machinery/light/small{
	dir = 4;
	light_color = "#d8b1b1"
	},
/obj/effect/decal/cleanable/dirt,
/obj/machinery/recharger,
/turf/open/floor/mineral/titanium,
/area/shuttle/mining)
"g" = (
/turf/open/floor/mineral/titanium,
/area/shuttle/mining)
"h" = (
/obj/effect/decal/cleanable/dirt,
/turf/open/floor/mineral/titanium,
/area/shuttle/mining)
"i" = (
/obj/machinery/door/airlock/shuttle{
	name = "Mining Shuttle Airlock"
	},
/obj/effect/turf_decal/stripes/line{
	dir = 8
	},
/obj/effect/turf_decal/stripes/line{
	dir = 4
	},
/obj/docking_port/mobile{
	dir = 4;
	dwidth = 3;
	height = 5;
	id = "mining";
	name = "mining shuttle";
	port_direction = 8;
	width = 7
	},
/obj/effect/mapping_helpers/airlock/cyclelink_helper{
	dir = 4
	},
/turf/open/floor/mineral/titanium,
/area/shuttle/mining)
"j" = (
/obj/machinery/door/airlock/shuttle{
	name = "Mining Shuttle Airlock"
	},
/obj/effect/turf_decal/stripes/line{
	dir = 8
	},
/obj/effect/turf_decal/stripes/line{
	dir = 4
	},
/obj/effect/mapping_helpers/airlock/cyclelink_helper{
	dir = 8
	},
/turf/open/floor/mineral/titanium,
/area/shuttle/mining)
"k" = (
/obj/structure/chair/comfy/shuttle{
	dir = 1
	},
/obj/effect/decal/cleanable/dirt,
/turf/open/floor/mineral/titanium,
/area/shuttle/mining)
"l" = (
/obj/structure/chair/comfy/shuttle{
	dir = 1
	},
/obj/effect/turf_decal/stripes/line,
/obj/effect/decal/cleanable/blood/old,
/turf/open/floor/mineral/titanium,
/area/shuttle/mining)
"m" = (
/obj/structure/shuttle/engine/heater,
/obj/structure/window/reinforced{
	dir = 1;
	layer = 2.9
	},
/obj/structure/window/reinforced{
	dir = 8
	},
/obj/structure/window/reinforced{
	dir = 4
	},
/turf/open/floor/plating/airless,
/area/shuttle/mining)
"n" = (
/obj/structure/chair/comfy/shuttle{
	dir = 1
	},
/obj/effect/turf_decal/stripes/line,
/obj/effect/decal/cleanable/dirt,
/turf/open/floor/mineral/titanium,
/area/shuttle/mining)
"o" = (
/obj/structure/shuttle/engine/propulsion/burst,
/turf/open/floor/plating/airless,
/area/shuttle/mining)
"p" = (
/obj/structure/closet/crate/internals,
/obj/machinery/light/small{
	brightness = 3;
	dir = 8
	},
/obj/effect/turf_decal/bot,
/obj/item/clothing/suit/hazardvest{
	desc = "A high-visibility lifejacket complete with whistle and slot for oxygen tanks.";
	name = "emergency lifejacket"
	},
/obj/item/clothing/suit/hazardvest{
	desc = "A high-visibility lifejacket complete with whistle and slot for oxygen tanks.";
	name = "emergency lifejacket"
	},
/obj/item/clothing/suit/hazardvest{
	desc = "A high-visibility lifejacket complete with whistle and slot for oxygen tanks.";
	name = "emergency lifejacket"
	},
/obj/item/clothing/suit/hazardvest{
	desc = "A high-visibility lifejacket complete with whistle and slot for oxygen tanks.";
	name = "emergency lifejacket"
	},
/obj/item/tank/internals/emergency_oxygen/engi,
/obj/item/tank/internals/emergency_oxygen/engi,
/obj/item/tank/internals/emergency_oxygen/engi,
/obj/item/tank/internals/emergency_oxygen/engi,
/obj/item/clothing/mask/breath,
/obj/item/clothing/mask/breath,
/obj/item/clothing/mask/breath,
/obj/item/clothing/mask/breath,
/obj/item/clothing/head/hardhat/orange,
/obj/item/clothing/head/hardhat/orange,
/obj/item/clothing/head/hardhat/orange,
/obj/item/clothing/head/hardhat/orange,
/obj/item/pickaxe/emergency,
/obj/item/pickaxe/emergency,
/turf/open/floor/mineral/titanium,
/area/shuttle/mining)
"q" = (
/obj/structure/ore_box,
/obj/machinery/light/small{
	dir = 4;
	light_color = "#d8b1b1"
	},
/obj/effect/turf_decal/bot,
/obj/effect/decal/cleanable/dirt,
/turf/open/floor/mineral/titanium,
/area/shuttle/mining)

(1,1,1) = {"
a
b
c
i
c
b
b
"}
(2,1,1) = {"
b
d
h
g
l
p
b
"}
(3,1,1) = {"
c
e
k
g
n
m
o
"}
(4,1,1) = {"
b
f
g
h
n
q
b
"}
(5,1,1) = {"
a
b
c
j
c
b
b
"}
